  O OO   OO O O    OO      OO  
   OO      OO O O    OO O  OO  
 OO    O O  OO O         OO O  
               OO   O O  O  OOO
        OOOOOO      OO  O   OO 
OOOO  O O     O  . O OOO OO OO 
      OO  O    O   O      OO   
O      O  OO   O OO     OO O  O
   O   O  OO OOO       OOO    O
 OO  O      OO   OO   OO  O    
        O      O   O   O   O  O
  OO  O     O O O     O     O O
O O         O O OOO       OOO  
 OOO     O   OO OOO    O OO  OO
O    OO  O  OO  O   O  O  OO  O
O     OO  O O  XO  OOO     OOOO
 O    O        O O OOOO O O  O 
     OO OOO O  O       O  OOOO 
O OO  O O O  O OO  O     O O   
  O      OO O     O O       O  
   O       O    O     O     O  
 O         OO OO     O    O O O
O   O O      OO        O   OO O
    OOOOOOO   O  O O   O O  OOO
O   O O  OOO   OO    O   O     
O O  O O    OO  O O           O
O   O O  O             OO O    
 O O   O  OO OO    O        OO 
 OO          OO  O  O O    O  O
      OOO    O       O OO   OOO
  O   O     O O  O  O O        